0,0,0,0,0,0,0,0,0,0,0,0,0,0,0,0,0,0,0,0
0,0,0,0,0,0,0,0,0,0,0,0,0,0,0,0,0,0,0,0
0,0,0,0,g,g,g,g,0,0,0,0,g,g,g,g,0,0,0,0
0,0,0,0,0,0,0,0,0,0,0,0,0,0,0,0,0,0,0,0
0,0,0,0,0,0,g,g,g,g,g,g,g,g,0,0,0,0,0,0
g,0,0,0,0,0,0,0,0,0,0,0,0,0,0,0,0,0,0,g
0,g,0,0,0,0,0,0,0,g,0,0,0,0,0,0,0,0,g,0
0,0,g,0,0,0,0,g,0,0,0,0,g,0,0,0,0,g,0,0
0,0,0,0,0,0,0,g,0,0,0,0,g,0,0,0,0,0,0,0
g,g,g,g,0,0,0,0,0,0,0,0,0,0,0,0,g,g,g,g
0,0,0,0,0,0,0,0,0,0,0,0,0,0,0,0,0,0,0,0
0,0,0,0,0,0,0,0,0,0,0,0,0,0,0,0,0,0,0,0