0,0,0,0,0,0,0,0,0,0,0,0,0,0,0,0,0,0,0,0
0,0,0,0,0,0,0,0,0,0,0,0,0,0,0,0,0,0,0,0
0,0,0,0,h,g,g,h,0,0,0,0,h,g,g,h,0,0,0,0
0,0,0,0,0,0,0,0,0,0,0,0,0,0,0,0,0,0,0,0
0,0,0,0,0,0,h,h,h,g,g,h,h,h,0,0,0,0,0,0
g,0,0,0,0,0,0,0,0,0,0,0,0,0,0,0,0,0,0,g
0,g,0,0,0,0,0,0,0,h,h,0,0,0,0,0,0,0,g,0
0,0,g,0,0,0,0,g,0,0,0,0,g,0,0,0,0,g,0,0
0,0,0,0,0,0,0,g,0,0,0,0,g,0,0,0,0,0,0,0
g,g,g,g,0,0,0,0,0,0,0,0,0,0,0,0,g,g,g,g
0,0,0,0,0,0,0,0,0,0,0,0,0,0,0,0,0,0,0,0
0,0,0,0,0,0,0,0,0,0,0,0,0,0,0,0,0,0,0,0